0 0 0 0 0 0 0 1 0 0 0 0 
0 0 0 0 0 0 0 1 0 0 0 0 
0 0 0 0 0 0 0 1 0 0 0 0 
0 0 0 0 0 0 0 1 0 0 0 0 
0 0 0 1 1 1 1 1 0 0 0 0 
0 0 0 1 0 0 0 0 0 0 0 0 
0 0 0 1 1 1 1 1 1 0 0 0 
0 0 0 0 0 0 0 0 1 0 0 0 
0 0 0 0 0 0 0 0 1 0 0 0 
0 0 1 1 1 1 1 1 1 0 0 0 
0 0 1 0 0 0 0 0 0 0 0 0 
0 0 1 0 0 0 0 0 0 0 0 0 
19 31 43 55 54 53 52 51 63 75 76 77 78 79 80 92 104 116 115 114 113 112 111 110 122 134
2 11
7 0
100
50